15,15
#,#,#,#,#,#,#,#,#,#,#,#,#,#,#
#,P,_,_,_,_,#,#,#,_,_,_,_,P,#
#,_,#,_,#,_,_,#,_,_,#,_,#,_,#
#,_,#,_,#,#,_,#,_,#,#,_,#,_,#
#,_,#,_,_,#,_,#,_,#,_,_,#,_,#
#,_,#,#,_,_,_,_,_,_,_,#,#,_,#
#,_,_,_,_,#,#,_,#,#,_,_,_,_,#
#,_,#,#,_,#,_,_,_,#,_,#,#,_,#
#,_,#,_,_,#,#,#,#,#,_,_,#,_,#
#,_,_,_,#,#,#,_,#,#,#,_,_,_,#
#,_,#,_,#,_,_,_,_,_,#,_,#,_,#
#,_,#,_,_,_,#,_,#,_,_,_,#,_,#
#,_,#,#,_,#,#,_,#,#,_,#,#,_,#
#,P,_,_,_,_,_,_,_,_,_,_,_,P,#
#,#,#,#,#,#,#,#,#,#,#,#,#,#,#