15,15
10,50,5,5,1
#,#,#,#,#,#,#,#,#,#,#,#,#,#,#
#,P,_,_,_,_,#,#,#,_,_,_,_,P,#
#,_,#,_,#,_,_,#,_,_,#,_,#,_,#
#,_,#,_,#,#,_,#,_,#,#,_,#,_,#
#,_,#,_,_,#,_,#,_,#,_,_,#,_,#
#,_,#,#,_,F,_,_,_,_,_,#,#,_,#
#,_,_,_,_,#,#,_,#,#,_,_,_,_,#
#,_,#,#,_,#,_,G,_,#,_,#,#,_,#
#,_,#,_,_,#,#,#,#,#,_,_,#,_,#
#,_,_,_,#,#,#,_,#,#,#,F,_,_,#
#,_,#,_,#,_,_,S,_,_,#,_,#,_,#
#,_,#,_,_,_,#,_,#,_,_,_,#,_,#
#,_,#,#,_,#,#,_,#,#,_,#,#,_,#
#,P,_,_,_,_,_,_,_,_,_,_,_,P,#
#,#,#,#,#,#,#,#,#,#,#,#,#,#,#